9+@=
++++@++++++@++
++++@@++++++++
+++++++++@+@@+
+++++++++++++@
++++++++++++++
+@+@++++@+@+++
++++@@++++++@@
++@+++++++++++
+++++++++++@++
