40~!H
~~~~~~!~~~~~~~~~~~~~~~~~~~~~~~~~~~~~~~~~~~~~~~~~!~
~~~~~~~~~~~~~~~~~~~~~~~~~~~~~~~~~!~~!~~~~~~~~~~~~~
~~~~~~~~~~~~~~~~~~~~~~~~~~~!~~~~~!~~~~!~~~~~~~~~~~
~~~~!~~~~~~~~~~!~~~~~~~~~~~~~~~~~~~~~~~~~~~~~~~~~~
~~~~~~~~~~~~~~~~~~~~~~!~~~!~~~~~~~~~~~~~~~~~~~~~~~
~~~~~~~!~~~~~~~~~~~~~~~~~~~~~~~~!~~~~~~~~~~~~!!~~~
~~~~~~~~~~~~~~~~~~~~~~~~~~~~~~~~~~~~!~~~~~~~~~~~~~
~~~~~~~~~~~~~~~~~~!~~~~~~~~~~~~~!~~~~~~~~!~~~~~~~!
~~~~~~~~~!~~!~~~~~~~~~~~~~~~~~~~~~~~~~~~~~~~~~~~~~
~~~~~~~~~~~~~~~~~~~~~~~~~!~~~~~~~~!~~!~~~~~~~~!~~!
~~~~~~~~~~~~~~~~~~~~~~~~~~~~~~~!~~~~~~~~~~~~~~~~~~
!~~~~~~~~~~~~~~~!~~~~~~~!~~~~~!~~~~~~~~~!~~~~~~~!~
~~~!~~~~!~~~~~~~~~~~~~~~~~~~~~~~~~~~~~~~~~~~!~~~~~
~~~~~~~~~~~~~~~~~~~~~~~~~!~~~~~~~~~!~~!~~~~~~~~~~~
~~~~~~~~~~~~~!~~~~!~~~~~~~~~~~~~~~~!~~~~~~~~~~~~~~
~~~!~~~~~~~~~~~~~~~~~~~~~~~~~!~~~~~~~~~~~~~~~~~~~~
~~~~~~~~~~~~~~~!~~~~~~~~~~~~~~~~~~~~~~!~~~~~~~~~~~
~~~~~~!~~~~~~~~~~~!~~~~~!~~~~~~~~~~~~~~~~~~~~~~~~~
~~~~~~~~~~!~~~~~~~~~~~~~~~~~~~~~~~~~~~~~~~~~~~~~~~
~~~~~~~~~~~~~~~~~~~~~~~~~~!~~~!~~~~~!~~~~~~!~~~~~~
~~~~~~~~~!~~~~~~~~~!~!~~~~~~~~~~~~!~~~~~~~~~~!~~~!
!~!~~~~~~~~~!~~~~~~!~~~~~!~~~~!~~~~~~~~~~~~~~~~~!~
~~~~~~~~~~~~~~~~~!~~~~~~~~~~~~~~~~~~~~~~~~~~~~~~~~
~!~~~~~~~~~~~~~~~~~~~!~~~~!~~~~~~~~~!~~~~~~~~~~~~~
~~~~~~!~~~~~~~~~~~~~~~~~~~~~!~~~~~~~~~~~~~~~~~~~~~
~~~~~~~~~~~~~~~~~~~!~~!~~~~~~~~~~~~~~~~~~~~~~~~~~~
~~~~~~~~~~~~~~~~~~~~~~~~~~~!~~~~~~~~~~~~~~~~~~~~~~
~~~~~!~~~~~~~~!~~!~~!~~~~~~~~~~~~~~~~!~~~~~~~~~~~~
~~~~~~~!~~~~~~~~~~~~~~~~~~~!~~~~~~~~~~~~~~~~~~~~~~
~~~~~~~~~~~~~~~~~~~~~~~~~~~~~~!~~~~~~~~~~~~~~~~~~~
~~~~~~~~~~~~~~~~~~~~~~~~~~~~~~~~~~~~~~~~!~~~~~~~~~
!~~~~~~~~~~~~~~~!~~~~~~~~~~~~~~!~~!~~~~~~~~~~!~~~~
~~~~~~~~~~~!~~~~!~~~~~~~~~~~~~~~~~~~~~~~~~~!~~!~~~
~~~~~~~~~~~~!~~~~~~~~~~~~~~~~~~~~~!~!~~~~~~~~~~~~~
~~~~~~~~~~~~~~~~~~~~~~~~~~!~~~~~~~~~~~~~~~~~~~~~~~
~~~~~~~~~~~~~~~~!~~~~~~~~~~~~!~~~~~~~!~~~~~~~~~~~~
~~~!~~~~~~~~~~~~~~~~!~~!~~~~~~~~~~~~~~~~~~~~~~~~~~
~~~!~~~~~~~~~~~~~~~~!~~~~~~~~~~~~~~~~~~~~~~~~~~~~~
~~~~~!~~~~~!~~~~~~!!~~~~~~~~~~~~~~!~~~~~~~~~~~~~~~
~~~~~~~~!~~~~~~~~!~~~~~~~~~~~!~~~~~~~~~~~~~~~~~~~~
